1111111111111111111111111111111111111111111111111
1111111111111111111111111111111111111111111111111
1100000000000000000000000000000000000000000000011
1100000090000000000090000000000900000900009000011
1100000000000000000000000000000000000000000000011
1100000000000000000000000000000000000000000000011
1133333333333333333332222333333333333333333333311
1122222222222222222223333222222222222222222222211
1133333333333333333332222333333333333333333333311
1100000000000000000000000000000000000000000000011
1100000000000000000000000000000000000000000000011
1100000000000000000000000000000000000000000000011
1100000000000000000000000000000000000000000000011
1133333333333333333332222333333333333333333333311
1122222222222222222223333222222222222222222222211
1133333333333333333332222333333333333333333333311
1100000000000000000000000000000000000000000000011
1100000000000000000000000000000000000000000000011
1100000080000000000080000000000800000800008000011
1100000000000000000000000000000000000000000000011
1111111111111111111111111111111111111111111111111
1111111111111111111111111111111111111111111111111